12 12
############
S  #     # #
  #  #  #  #
 #  #  #   #
   #  #  # #
  #  #  #  #
 #  #  #  ##
#  #  #  # #
  #  #  #  # 
 #  #  #   #
   #     #E#
############
